S..........#.............
.###.#.###.#.###.#######.
.#.#.#.#.#.#.#...#.......
.#.#.###.#.#.#.###.###.#.
...#.......#.#.#...#...#.
.#########.#.###.#######.
.........#...#.#.........
####.###.#.###.##########
.....###.#.#.#...........
.###.###.#.#.###########.
.#.#.....#.#.............
##.#######.#.#.#########.
...........#.#.#.......#.
.#########.#.#.#.#####.#.
.#.........#.#.#.....#.#.
.#############.#####.#.#.
.#...#...#...#.......#.#.
.#.#.#.#.#.#.#########.#.
...#...#...#...........#F
